S  ████████████████████████████████████████████████████████████████████████████████████████
         █     █                 █        █  █     █     █     █  █  █  █  █              █
█  █  ████  █  ████  █  ████  █  ████  ████  █  ████  ███████  █  █  █  █  █  █  ████  ████
█  █  █     █  █     █  █     █              █  █              █        █  █  █  █        █
█  ██████████  ████  ██████████  ████  ███████  ██████████  █  █  █  ████  ██████████  ████
█     █                    █     █  █        █  █        █  █     █  █  █  █        █     █
█  ██████████  ███████  ██████████  ████  ████  █  █  ████  ████  ████  █  █  ███████  █  █
█     █     █  █     █  █     █     █        █     █        █  █                 █  █  █  █
█  ███████  █  █  ████  ████  ████  ██████████  ████  ███████  █  ████  ██████████  ████  █
█  █              █  █           █  █           █              █     █           █        █
█  ████  ████  █  █  █  ████  █  █  █  ███████  ████  █████████████  ████  █  █  ████  ████
█        █  █  █  █        █  █  █     █     █     █  █     █        █  █  █  █  █        █
████  ████  █  █  █  █  ████  ███████  █  █  ████  ████  ████  ███████  ████  ███████  ████
█           █  █  █  █  █  █           █  █     █  █        █     █  █        █           █
████████████████  ███████  ███████  ██████████  ███████  █  █  ████  ███████  █  ██████████
█     █        █     █     █     █  █  █           █  █  █        █           █        █  █
█  ████  ███████  ████  ████  ███████  ███████  ████  ███████  ████  █  ████  █  ███████  █
█           █  █  █     █           █  █     █           █     █     █  █        █     █  █
█  ███████  █  ████  ███████  █  ████  ████  ███████  █  █  ████████████████  █  ████  █  █
█     █  █  █     █        █  █  █        █           █     █  █           █  █     █  █  █
█  ████  █  ████  █  █  ████  █  ████  ████  ████  ████  ████  █  ███████  ██████████  █  █
█     █              █        █        █  █  █  █     █  █  █     █        █     █        █
█  █  ███████  █  ████  █  █  ███████  █  █  █  ██████████  █  █  ████  ███████  █  █  ████
█  █  █     █  █  █     █  █  █  █  █  █           █  █  █  █  █  █  █              █  █  █
███████  ████  ████████████████  █  █  ████  █  █  █  █  █  █  ████  █  █  █  █  ███████  █
█        █  █              █     █  █  █     █  █  █  █  █        █     █  █  █  █  █     █
███████  █  █  █  █  ████  █  █  █  █  █  ████  ████  █  ████  ██████████  ███████  █  █  █
█              █  █  █  █  █  █  █        █              █        █     █  █           █  █
█  █  █  █████████████  ███████  ████  ███████  █  █  ███████  ████  █  █  ████  █  ███████
█  █  █     █     █  █  █  █           █     █  █  █                 █  █  █     █        █
█████████████  █  █  █  █  ████  █  ███████  █  ███████  ████████████████  █  █  █  ████  █
█  █     █  █  █              █  █     █           █     █           █        █  █  █  █  █
█  █  █  █  ████  █  █  █████████████  ████  ████  ████████████████  █  ██████████  █  ████
█     █           █  █  █  █     █        █  █     █     █                 █              █
█  ██████████  █  ████  █  █  ████  █  ███████  ████  ███████  █  ████  ████  █  ████  ████
█     █     █  █  █           █     █  █     █           █  █  █  █     █     █  █        █
█  ███████  ████  ████  █  ██████████  █  █  █  ████  █  █  █████████████  ████  █  ███████
█     █           █  █  █  █  █  █     █  █     █     █           █        █  █  █     █  █
████  █  ████  ████  ████  █  █  ██████████  ████  ███████  ████  ███████  █  ████  ████  █
█  █  █  █           █  █        █              █  █           █  █  █        █     █     █
█  ████  ███████  ████  █  █  ████  █  █  █████████████████████████  ██████████  ████  █  █
█  █     █     █  █  █     █        █  █              █           █     █  █           █  █
█  █  ████  ███████  ██████████  ████  ████  ████  ██████████  ████  ████  █  █████████████
█        █                    █  █        █     █           █     █        █  █  █        █
████  ███████  █  █  ████  █  ████  ██████████  █  ██████████  ███████  ████  █  ████  ████
█  █        █  █  █  █  █  █        █           █     █                 █     █     █     █
█  █  █  █  ██████████  █  █  █  █  ███████  ████  ███████  █  ████████████████  ███████  █
█  █  █  █  █     █        █  █  █        █     █  █  █     █        █     █  █           █
█  █  ██████████  █  █  ██████████  ████  █  █  █  █  ███████  ███████  █  █  ████  ████  █
█     █     █  █     █  █              █  █  █  █  █              █  █  █        █     █  █
█  █  █  ████  ██████████  ██████████████████████  █  █████████████  ████  █████████████  █
█  █     █        █                       █  █  █     █     █     █     █        █        █
██████████  ███████  ██████████  █  ███████  █  █  ████  █  █  ████  ██████████  ███████  █
█           █  █        █  █  █  █  █           █     █  █        █     █  █              █
█  █  ████  █  ████  ████  █  ████  █  █  ███████  ███████  █  ███████  █  ████  ██████████
█  █  █     █     █  █     █     █  █  █     █     █     █  █              █              █
█  █  ████  █  █  ████  █  ████  █  ████  ███████  █  █  █  ████  █  █  ████  ██████████  █
█  █  █        █     █  █              █  █     █     █     █     █  █           █        █
█  █████████████  █  ███████  ████  ████  █  ███████  █  ████  ████  ████  █  ████  █  █  █
█           █     █              █           █        █     █     █     █  █  █     █  █  
████████████████████████████████████████████████████████████████████████████████████████  E