S  ████████████████████████████████████████████████████████████████████████████████████████████████████████████████████████████████████████████████████
               █  █        █     █  █  █        █                 █           █        █     █     █  █     █     █        █  █        █              █
████  ███████  █  ███████  ████  █  █  ████  ██████████  █  ████  ████  █  ███████  ████  ████  ████  ████  ████  ████  █  █  ████  ███████  █  ███████
█     █              █     █     █        █  █  █        █  █  █        █  █        █     █  █              █           █        █  █        █  █     █
█  █  ███████  ██████████  ████  ███████  █  █  █  ████  █  █  █  ███████  ████  ████  █  █  █  █████████████████████████  ████  █  ██████████  █  ████
█  █  █        █  █     █  █  █                 █  █     █  █  █  █     █              █        █     █        █        █  █        █              █  █
█  ████  ████  █  █  █  █  █  █  █  █  █  ███████  ███████  █  █  █  ████████████████  █  ██████████  █  ████  █  █████████████  ████  █  ███████  █  █
█     █  █        █  █  █        █  █  █           █  █  █  █  █  █        █  █  █  █  █  █     █     █  █           █  █  █     █     █        █     █
█  █  ███████  ████  ████  ████  █  █  █████████████  █  ████  █  █  ███████  █  █  █  ███████  █  ██████████  ███████  █  ████  █  █  ███████  █  █  █
█  █  █     █        █        █  █  █  █     █     █     █     █  █           █     █  █  █        █           █  █              █  █  █  █     █  █  █
█  █  █  █  ███████  █  ████  █  ███████  ███████  █  █  █  █  █  ███████  ████  █  ████  █  ███████  ██████████  █  █  █  █████████████  █  ████  ████
█  █  █  █  █           █     █     █        █  █     █     █                    █        █           █              █  █  █  █     █        █  █  █  █
██████████  ████  ███████  ██████████  ████  █  █  ████  ██████████  █  ████  ██████████████████████  ████  ██████████  ████  ████  ████  ████  █  █  █
█     █           █  █  █  █     █     █  █  █  █  █  █        █     █  █     █        █              █     █        █                    █  █  █  █  █
█  █  ████  █  ████  █  ████  █  ████  █  █  █  █  █  ██████████████████████  █  █  ███████  █  █████████████  ████  ████  █  █  █  █  █  █  █  █  █  █
█  █        █        █  █  █  █  █     █        █  █  █  █        █           █  █  █     █  █              █     █        █  █  █  █  █  █     █     █
████  ██████████  █  █  █  ████  █  █  █████████████  █  ████  █████████████  █  █  █  ██████████  █  █  ████  █  ███████  ██████████  ████  █  ████  █
█     █  █     █  █        █        █        █     █  █        █     █     █     █        █        █  █     █  █  █        █                 █     █  █
███████  █  █  ████  █  ███████  █  █  ████  ████  █  ███████  █  ████  █  ████  ███████  ███████  █  █  ██████████  ████  ██████████  ███████  ███████
█  █        █  █     █           █  █  █     █        █              █  █     █     █           █  █  █     █  █     █     █     █     █  █     █  █  █
█  ██████████  ██████████  ██████████  ███████  █  ████  ███████  ██████████  █  █  █████████████  █  ████  █  ████  ███████  █  █  ████  █  ████  █  █
█  █  █  █  █     █     █     █  █           █  █  █     █     █              █  █     █     █     █  █  █  █        █  █     █  █  █                 █
█  █  █  █  █  █  █  ██████████  ████  █  ████  ████  █  █  ████████████████  ███████  ████  ████  ████  █████████████  █  ███████  █  █  ██████████  █
█              █        █        █     █     █     █  █           █  █     █                    █              █     █           █  █  █     █  █  █  █
███████  █  ████████████████  █  ██████████  █  ██████████  ███████  ████  ██████████  ████  ████  █  ████  ███████  ███████  ███████  ████  █  █  ████
█  █  █  █  █                 █        █     █     █  █     █     █        █  █           █  █  █  █     █  █     █     █           █  █  █        █  █
█  █  ████  █  ████  ██████████  █████████████  █  █  ██████████  █  █  █  █  █  ██████████  █  █  ██████████  █  █  ████  ███████  ████  █  ███████  █
█           █  █        █                 █     █  █     █           █  █                 █  █  █              █  █           █                    █  █
█  ████  ████████████████  ████  █████████████  █  █  ███████  ██████████  █  █████████████  █  ██████████  █  ██████████  ████████████████  ███████  █
█     █                 █  █     █        █  █  █           █     █  █  █  █        █     █           █     █     █        █  █  █           █  █     █
█  ████  ████  ██████████  ████  █  █  ████  █  ██████████  █  ████  █  █  ████  ████  ███████  ███████  █  ████  ████  ████  █  ████  ████  █  █  ████
█  █  █     █     █  █     █  █     █     █  █     █     █  █     █        █  █     █           █  █     █     █                    █  █        █  █  █
█  █  ███████  ████  █  █  █  █  ████  █  █  █  ████  ██████████  ████  █  █  ███████  █  █  █  █  █  ████  █  █████████████  █  █  ███████  ████  █  █
█  █        █  █        █  █  █  █     █  █     █     █  █        █  █  █  █  █        █  █  █  █  █  █     █        █  █     █  █     █              █
████  ███████  ██████████  █  █  █████████████  ████  █  ██████████  █  ████  ██████████  █  █  █  ████  █████████████  ████████████████  █████████████
█     █     █     █     █  █           █  █        █     █  █        █     █  █  █  █  █  █  █     █     █  █              █     █     █     █  █     █
█  ████  ███████  ████  █  █  ████  ████  ████  ███████  █  █  ████  ████  █  █  █  █  █  ███████  █  █  █  █  ███████  ████  ████  ████  ████  █  ████
█                          █     █  █  █           █  █  █  █  █        █  █     █        █           █     █  █        █        █  █              █  █
█  ████  █  █  ██████████  ███████  █  █  █  █  ████  █  █  █  ████  ███████  █  █████████████  █  ████  █  █  ███████  █  ████  █  ████  ███████  █  █
█  █     █  █  █              █           █  █        █           █     █  █  █              █  █  █  █  █  █  █  █  █  █  █     █        █  █        █
████  ██████████  ████  ███████  ████  ████  ████  █  ████  ████  █  ████  █████████████  █  █  █  █  █  ████  █  █  ████  ████  ████  █  █  █  ████  █
█        █     █     █  █        █  █  █        █  █        █     █  █        █        █  █     █  █     █  █           █     █  █     █  █        █  █
█  ████  ████  █  ████  █  ████  █  ██████████  █  █  █████████████  █  █████████████  ████  ███████  █  █  █  █  ████  ████  █  ██████████  █  ████  █
█  █  █        █  █     █     █        █        █  █  █                 █     █        █  █        █  █  █  █  █  █     █  █  █     █  █     █  █     █
████  █  █  ████  █  ███████  ████████████████  ███████  ████  █  ████  █  ██████████  █  ████  ███████  █  █  ████  ████  █  █  ████  █  ████  █  ████
█     █  █  █  █  █        █        █        █  █  █     █     █     █           █  █           █  █     █        █           █        █  █     █  █  █
█  █  ████  █  █  █████████████  ████  ███████  █  █  ████  ██████████  ████  ████  ██████████  █  ██████████  █████████████  █  ████████████████  █  █
█  █           █           █     █     █  █     █  █     █  █        █  █     █  █     █  █           █     █           █     █  █  █     █  █  █  █  █
█  ██████████  ████████████████  ████  █  ████  █  ███████  ████  ██████████  █  ████  █  █  ███████  █  █  ███████  ████  █  ████  █  ████  █  █  █  █
█     █        █           █        █     █  █  █                 █              █  █  █  █     █  █  █  █           █     █                 █        █
█  █  ████  █  █  ███████  ███████  ████  █  █  ████  █████████████  █  █  ████  █  █  █  ███████  █  ████  ██████████  ████  █  ████  ████  ███████  █
█  █     █  █  █  █  █        █  █  █  █        █  █  █  █           █  █     █        █  █        █     █     █     █  █     █  █  █     █     █     █
███████  ███████  █  ████  ████  █  █  ██████████  █  █  █  █  ████  ████  █  █  ████  █  ████  ████  ██████████  ████████████████  ████  ███████  █  █
█        █     █  █        █  █  █  █        █           █  █  █     █     █  █     █  █     █        █        █     █     █  █        █  █     █  █  █
████  ████  ████  ███████  █  █  █  █  ████  ███████████████████  █  ██████████  █  ███████  ████  ████  ████  ████  █  █  █  ████  ████  ████  █  █  █
█           █  █     █  █        █     █           █              █     █        █  █     █              █  █     █     █     █  █  █        █     █  █
█  ████  ████  █  ████  ████  ████  █  ████  ██████████  ████████████████  ███████  █  █  █  █  ██████████  █  █████████████  █  █  █  █  █  █  █  ████
█  █        █        █  █     █     █     █        █  █           █              █  █  █     █  █        █        █     █           █  █  █  █  █     █
████  █  █  █  ███████  ████  ████  █  ████  ████  █  ████  ████  ████  ████  █  ███████  ████  ███████  █  █  ████  █████████████  █  ████  █  █  ████
█     █  █  █  █        █           █  █     █  █        █     █  █  █  █     █     █     █  █  █           █     █     █              █     █  █  █  █
████  ████  ██████████  █████████████  █  ████  █████████████  ████  █  ███████  ███████  █  █  █  █  ███████  ████  █████████████  ███████  ████  █  █
█     █  █  █        █        █     █  █           █     █     █              █  █     █  █     █  █     █  █              █  █     █           █     █
█  ████  ████  █  ███████  ████  ██████████████████████  ████  ███████████████████  █████████████  ███████  ███████  ███████  █  █  ███████  ██████████
█  █        █  █        █        █  █              █  █  █  █           █  █  █  █           █  █        █     █        █  █  █  █  █        █  █  █  █
███████  ████  ███████  █  █  ████  ███████  █  ████  █  █  ████  ████  █  █  █  ████  ███████  █  ████  █  ███████  █  █  █  █  ██████████  █  █  █  █
█                 █        █     █        █  █           █           █           █        █     █  █        █     █  █     █  █     █  █  █     █     █
████  █  █  ███████  ████  █  █  █  █  ██████████  ████  █  ████  █████████████  █  ███████  ███████  ███████  █  ███████  █  █  ████  █  ████  █  ████
█     █  █  █           █  █  █     █     █  █     █           █  █  █     █                 █  █        █     █  █  █           █  █                 █
████  █████████████  ██████████  ████  █  █  █  █  █  █  █  ████  █  ████  █  ████████████████  ██████████  █  ████  ███████  █  █  ███████████████████
█     █     █        █  █     █  █     █     █  █  █  █  █  █  █     █  █  █        █     █     █  █        █  █           █  █     █  █        █     █
████  █  █  ████  ████  ████  █  ████  █  █  █  ████  ███████  █  █  █  █  █  █  ████  ███████  █  █  ████  ███████  ████  █  █  █  █  █  █  ████  ████
█  █     █  █  █     █        █     █  █  █  █  █  █           █  █  █  █     █        █     █        █        █  █     █     █  █     █  █     █     █
█  █  ███████  █  █  ███████  ████  █  █  ████  █  ████  █████████████  █  ██████████  █  ████  █  █  ███████  █  █  █  ███████  █  ███████  █  █  ████
█        █     █  █  █     █     █  █  █     █     █  █  █           █  █     █  █     █  █  █  █  █  █  █     █  █  █     █  █  █           █        █
███████  ████  ███████  █  ████  ████  ████  ████  █  ████  █  ███████  ███████  ████  █  █  █  ███████  █  █  █  █  ████  █  █  █  █  █  █  █  █  █  █
█        █     █  █  █  █        █        █  █     █     █  █                    █        █     █     █  █  █     █  █  █  █  █  █  █  █  █  █  █  █  █
████  █  █  ████  █  ████  ████  █  ███████  █  ████  ██████████  ████  ████  █  ████  ████  ███████  █  ███████  █  █  ████  █  ███████  ████  ████  █
█     █        █        █  █  █     █  █     █     █     █           █  █     █  █        █  █  █                       █  █     █        █     █     █
█  ██████████  ████  ███████  █  ████  ████  ████  ████  █  ████  ████  ████  ███████  ███████  ███████  █  █  ███████  █  █  █  █  ████  ██████████  █
█        █              █  █        █     █        █  █  █     █     █  █                    █        █  █  █  █     █  █  █  █  █     █        █  █  █
███████  █  ████  █  ████  █  ██████████  █  █  ████  █  ████  ████  ████  █  █  █  █  █  ████  ██████████  █  ████  ████  ████  █  ██████████  █  ████
█     █  █  █     █  █     █  █        █  █  █  █        █  █  █  █  █     █  █  █  █  █  █     █           █        █           █  █  █           █  █
████  ████  ███████  █  █  ████  ████  █  █  ███████  ████  ████  ███████  █  █  █  ███████  ███████  ████  ████  █  ████  ██████████  ███████  ████  █
█     █  █  █           █  █     █  █           █  █     █        █     █  █  █  █        █  █     █  █  █     █  █  █        █        █              █
█  ████  █  █  ███████████████████  ████  ███████  ████  █  ███████  ███████  █████████████  ████  █  █  █  ████  ████  ███████  ██████████████████████
█        █  █     █     █  █     █     █  █  █  █  █  █  █     █                    █  █  █     █     █     █        █  █     █        █        █     █
█  ███████  ███████  ████  █  ████  ████  █  █  █  █  █  █  █  █  ███████  ███████  █  █  ████  █  █████████████  ███████  ███████  ████  █  ████  ████
█        █        █     █                                   █  █  █        █                 █        █              █              █     █  █        █
███████  █  ████  █  █  ██████████  ████  █  ████  ██████████  ███████  ████  █  █████████████  █  ███████  █  █  █  █  █  ███████  ████  █  █  █  ████
█  █  █  █  █  █  █  █     █     █  █  █  █     █     █        █  █        █  █              █  █        █  █  █  █  █  █  █           █  █     █     █
█  █  █  █  █  █  ████  ███████  █  █  █  ██████████████████████  █  ███████████████████  █  ████  █  ██████████  ███████████████████  ████  ████  ████
█  █        █  █           █           █     █                    █     █                 █     █  █  █  █  █  █  █              █        █  █  █  █  █
█  █  █  █  █  ████  ███████  ███████████████████  ████  ███████████████████  ████████████████  ████  █  █  █  █  ███████  ███████  ████  ████  █  █  █
█     █  █        █        █  █  █        █           █     █  █        █  █        █        █  █        █     █  █        █     █  █  █  █     █  █  █
█  ████  █  ██████████  ███████  █  █  ████  ███████  ████  █  █  █  ████  ████  ████  █  ████  ████  █  █  █  ███████  █  █  ████  █  █  █  █  █  █  █
█     █  █  █  █  █     █           █  █  █  █  █  █     █        █     █     █  █     █        █  █  █  █  █        █  █     █     █        █  █     █
█  █  ████  █  █  ████████████████  ████  █  █  █  █████████████  ████  ████  ████  ████  ████  █  ████  █  ████████████████  █  ███████  █  ████  █  █
█  █  █                 █  █  █  █     █  █  █              █        █           █  █  █     █  █  █           █     █     █        █  █  █        █  █
███████  █  █  ███████  █  █  █  █  ████  █  ███████  ████  ████  █  █  █  █  ████  █  █  ████  █  ███████  ████  ███████  ████  █  █  █  ██████████  █
█        █  █        █     █                       █  █           █  █  █  █        █        █                                   █     █           █  
████████████████████████████████████████████████████████████████████████████████████████████████████████████████████████████████████████████████████  E