S  ██████████████████████████████████████████████████████████████████████████████████████████████████████████████████████
         █        █     █           █        █              █  █  █                 █     █     █     █           █  █  █
█  ███████  ███████  █  █  ██████████  █  ████  ██████████  █  █  ███████  ████  ████  ████  █  █  ████  ████  █  █  █  █
█     █              █     █  █  █  █  █     █  █           █  █        █  █     █        █  █        █     █  █     █  █
████  █  █  ████  ████  █  █  █  █  ████  ████  ████  ████  █  ███████  ████  █  █  █  ████  ███████  █  ██████████  █  █
█  █  █  █     █  █  █  █  █  █  █     █     █  █  █     █     █              █     █  █  █  █     █        █     █     █
█  █  ███████  ████  ████  █  █  █  ███████  ████  █  ████  █  ████  ████  ██████████  █  ████  █  █  ████  █  █  █  ████
█  █           █     █        █     █                 █     █  █  █     █  █  █  █  █           █        █     █  █     █
█  ████  ████  ████  ████  ████  ████  ███████  ████████████████  ████  ████  █  █  ███████  ██████████████████████  █  █
█        █     █  █  █  █  █     █     █  █     █     █  █  █     █  █  █                 █                       █  █  █
█  ████  █  █  █  █  █  ████  ████  █  █  ███████  ████  █  ████  █  ████  ████  ███████  █  ████  ███████████████████  █
█  █     █  █     █  █     █  █     █     █     █        █  █  █     █        █  █  █     █  █     █  █        █        █
█████████████  ████  █  ████  █  ██████████  █  ████  █  █  █  █  █████████████  █  ███████  █  ████  ████  ████  ███████
█  █           █  █              █  █     █  █     █  █           █                          █           █  █     █  █  █
█  ████  ████  █  █  ████  ███████  █  ██████████  █  ████  ███████  █  ████  █  ███████  █  █  ████  █  █  █  ████  █  █
█  █     █     █        █     █  █                    █  █  █        █     █  █  █        █  █     █  █  █  █     █  █  █
█  █  ███████  █  █  ███████  █  █████████████  ████  █  ████  ████  █████████████  ████  ███████  ███████  ███████  █  █
█        █        █        █        █  █           █     █     █  █     █        █     █     █     █        █           █
█  ████  ███████  █████████████  █  █  █  ████████████████  █  █  █  █  ███████  █████████████  █  █  █  ████  ███████  █
█  █  █  █     █  █  █     █  █  █  █           █     █  █  █  █  █  █  █     █           █     █  █  █        █  █     █
█  █  █  █  █  █  █  █  █  █  ████  ██████████  █  █  █  ████  █  ███████  ██████████  █  ███████  █████████████  ████  █
█     █  █  █     █  █  █     █     █     █     █  █                          █        █     █           █              █
█  ████  ██████████  ████  ███████  █  █  ████  ████  █  █  ███████  ███████████████████  █████████████  █  ████  ███████
█  █  █  █                    █     █  █     █     █  █  █  █        █                       █  █     █  █  █  █  █     █
████  ███████  █  ████  ███████  █  ████  █  ████  ████████████████  ███████  ██████████  ████  █  █  █  █  █  ███████  █
█     █        █     █        █  █  █  █  █     █        █        █     █     █                    █        █     █     █
█  ███████  ████  █  █  ████  █  █  █  █  █  ████  █  ███████  █  █  ██████████  ███████  █  █  ███████  █  ████  █  █  █
█  █  █        █  █  █     █  █  █     █  █  █     █     █     █     █     █  █     █     █  █  █  █  █  █     █     █  █
█  █  █  ████  ████  █  █  ███████  ████  ██████████  ████  █████████████  █  █  █  █████████████  █  █  █  ███████  ████
█  █        █     █  █  █  █  █     █     █           █              █  █  █  █  █  █  █                 █           █  █
█  ████  █  ███████  ███████  ████  ████  ████  ████  ████  ██████████  █  █  ███████  █  █  ████  ████  █  ████  █  █  █
█  █  █  █  █  █                    █           █     █        █        █     █     █  █  █  █        █  █     █  █     █
█  █  ███████  ████  ████  ███████  █  █  █████████████  █  █  █  █  ████  █  █  ████  █  █  █  █  █  ████████████████  █
█     █           █  █     █        █  █  █  █           █  █     █     █  █     █     █  █  █  █  █  █     █  █        █
█  █  ██████████  █  █  █████████████  ████  ████  ███████  █  █████████████  █  █  █  ████  █  █  █  █  █  █  ████  ████
█  █  █  █           █     █        █  █  █  █  █  █     █  █  █  █        █  █  █  █        █  █  █     █        █     █
████  █  █  █  █  █  █  ████  ███████  █  █  █  █  █  █  █  ████  ███████  █  ██████████  ████  ████  ███████  ███████  █
█  █        █  █  █  █  █     █  █  █        █        █  █        █     █                 █  █  █           █  █     █  █
█  █████████████  █  █  ████  █  █  ███████  ███████  ███████  ███████  █  █████████████  █  █  ████  ███████  ████  ████
█                 █  █  █  █        █     █     █     █     █     █  █              █        █  █        █     █  █     █
█  █  ████  ███████  ████  ████  ████  ████  ███████  ████  █  ████  ███████  ██████████  ████  ███████  ███████  ████  █
█  █  █     █  █     █     █     █                    █     █     █                    █  █     █           █           █
████  █  █  █  ███████  ████  █  ████  ████  █  █  █  █  █  ████  █  ████  █████████████  █  █  ████  ███████  █  ████  █
█  █  █  █  █     █     █     █           █  █  █  █     █  █  █  █  █  █  █              █  █  █  █  █  █     █  █     █
█  ████  █  █  ████  █  ████  ████  ███████  ████████████████  █  █  █  █  ████  ███████  ███████  ████  ████  ███████  █
█        █        █  █     █  █  █        █  █  █  █        █  █  █     █  █  █     █  █  █        █           █  █     █
█  ███████  ██████████  ████  █  ████  ███████  █  ███████  █  █  ██████████  █  ████  ██████████  █  █  ████  █  ███████
█     █              █     █  █  █     █     █     █     █  █              █     █     █     █  █     █     █     █  █  █
█  █  ███████  ████  █  ████  █  ██████████  █  ████  ████  ████  █  ███████  █  ████  ████  █  █  ████  █  ███████  █  █
█  █  █  █        █     █           █  █                 █  █  █  █  █        █  █              █  █     █  █     █     █
████  █  █  █  █  ████  ██████████  █  ███████  ████  ████  █  ██████████  █  █  ████  ███████  ███████  ████  ████  ████
█     █     █  █  █        █                 █     █  █  █  █     █  █     █  █           █        █     █  █  █  █     █
███████████████████  ███████  █  ████  ███████  █  █  █  █  █  ████  █  █  ████  █  █  ███████  █  █  ████  █  █  ████  █
█  █  █  █     █  █     █     █  █  █        █  █  █     █  █  █        █  █     █  █  █     █  █     █  █              █
█  █  █  █  █  █  █  █████████████  █  ████  ████  ████  █  █  █  ████  ████  ██████████  ████  ████  █  ████  ███████  █
█     █  █  █  █     █  █     █  █     █     █     █        █     █        █  █  █  █     █  █  █  █  █  █     █        █
█  █  █  █  ████  ████  █  ████  █  █  ████  █████████████  ███████  █  █  ████  █  ████  █  █  █  █  █  █  █  ███████  █
█  █           █  █           █     █     █     █        █  █        █  █     █  █        █     █     █  █  █  █  █  █  █
████  ████  █  █  ██████████  █  █  █████████████  █  █  █  ███████  ████  ████  █  ████  █  ████  ████  █  █  █  █  █  █
█     █  █  █  █                 █  █        █     █  █     █           █  █     █  █     █  █     █     █  █  █        █
███████  █  ███████████████████  ██████████  █████████████  █  ████  ███████  ████  ████  █  ████  █  ████████████████  █
█        █     █     █     █     █           █        █        █  █     █  █  █  █  █        █     █     █              █
████  ███████  █  ████  ███████  ████  ██████████  ██████████  █  ████  █  █  █  █████████████  ████  ███████  █  █  █  █
█     █        █     █     █     █     █     █                       █     █     █           █           █     █  █  █  █
█  ███████  █  █  ████  ████  █  █  █  ████  █  █████████████  ████  ████  ████  █  ████  ████  █  ███████████████████  █
█           █                 █  █  █  █  █     █  █     █        █  █     █  █     █     █  █  █  █                 █  █
██████████  ████  █  █  █  ████  ████  █  ███████  █  █  █  ██████████  █  █  ██████████  █  █  ████████████████  ████  █
█           █     █  █  █  █     █     █  █  █        █  █     █     █  █                    █  █              █        █
█  █  ███████  ████  ██████████  █  █  █  █  █  █  ████  █  █  █  ████  █████████████████████████  ████  ██████████  ████
█  █  █           █           █  █  █        █  █  █        █  █     █        █  █     █           █                 █  █
█  ██████████  ████  ████████████████  █  █  █  ████  ████  █  █  ██████████  █  █  █  █  ███████████████████  █  █  █  █
█  █           █     █           █  █  █  █     █     █     █     █        █  █  █  █  █           █  █  █     █  █     █
███████  ██████████  █  ████  █  █  █  █  █  █  ████  ███████████████████  █  █  █  ████  ███████  █  █  █  █████████████
█  █     █  █           █     █     █  █  █  █     █  █  █     █     █     █           █  █  █        █              █  █
█  █  ████  ████  ████  ████  ██████████  ██████████  █  ████  ████  ████  █  ████  █  ████  █  █  ████  █  █  █  █  █  █
█        █     █  █  █  █        █  █        █  █           █  █     █     █  █     █     █  █  █     █  █  █  █  █  █  █
█  ████  █  █  ████  █  ████  █  █  ████  ████  █  █  █  ████  ████  ████  ████  ███████  █  ██████████  ███████  ████  █
█     █     █  █     █  █     █  █           █  █  █  █     █              █        █        █     █        █           █
█  ████  ███████  ████  ████  █  █  █  ████  █  █  █  ████  ████  ████  █  ████  █████████████  ████  █  ████  ████  ████
█     █        █        █     █  █  █     █     █  █     █  █        █  █                             █  █     █        
██████████████████████████████████████████████████████████████████████████████████████████████████████████████████████  E